

++++
+  +
+  +++++
+      +
++W*+# +
+   +  +
+   ++++
+++++