


        +++++++   
    +++++  +  ++++
    +   +        + 
 ++++ +   ++ ++  + 
++      + +  ++ +++
+  +++ #+   #   # +
+*      + ++  +   +
+*  +    W + +++ ++
+*  +  +++        +
++++++++ ++   +   +
          +++++++++
