


           ++++++++
           +      +
++++++++++++     *+
+    +   #       *+
+    +  #  +     *+
+      #   +     *+
+    +#    ++++++++
+    +     +       
++W+++++++++       
 +++               
